000000000000000000000000000000000000000000000000000000000000000000000000000000000000000000000000000000000000000000000000000000000000000000000000000
000000000000000000000000000000000000000000000000000000000000000000000000000000000000000000000000000000000000000000000000000000000000000000000000000
000000000000000000000000000000000000000000000000000000000000000000000000000000000000000000000000000000000000000000000000000000000000000000000000000
000000000000000000000000000000000000000000000000000000000000000000000000000000000000000000000000000000000000000000000000000000000000000000000000000
000000000000000000000000000000000000000000000000000000000000000000000000000000000000000000000000000000000000000000000000000000000000000000000000000
000000000000000000000000000000000000000000000000000000000000000000000000000000000000000000000000000000000000000000000000000000000000000000000000000
000000000000000000000000000000000000000000000000000000000000000000000000000000000000000000000000000000000000000000000000000000000000000000000000000
000000000000000000000000000000000000000000000000000000000000000000000000000000000000000000000000000000000000000000000000000000000000000000000000000
000000000000000000000000000000000000000000000000000000000000000000000000000000000000000000000000000000000000000000000000000000000000000000000000000
000000000000000000000000000000000000000000000000000000000000000000000000000000000000000000000000000000000000000000000000000000000000000000000000000
000000000000000000000000000000000000000000000000000000000000000000000000000000000000000000000000000000000000000000000000000000000000000000000000000
000000000000000000000000000000000000000000000000000000000000000000000000000000000000000000000000000000000000000000000000000000000000000000000000000
000000000000000000000000000000000000000000000000000000000000000000000000000000000000000000000000000000000000000000000000000000000000000000000000000
000000000000000000000000000000000000000000000000000000000000000000000000000000000000000000000000000000000000000000000000000000000000000000000000000
000000000000000000000000000000000000000000000000000000000000000000000000000000000000000000000000000000000000000000000000000000000000000000000000000
000000000000000000000000000000000000000000000000000000000000000000000000000000000000000000000000000000000000000000000000000000000000000000000000000
000000000000000000000000000000000000000000000000000000000000000000000000000000000000000000000000000000000000000000000000M0O0M0000000000000000000000
000000000000000000000000000000000000000000000000000000000000000000000000000000000000000000000000000000M000M0000000000041111126680000000000000000000
000000000000000000000000000000000000000000000000000000000000000000000000000000000000000000000000000766666666668000000000<999999>0000000000000000000
000000000000000000000000000000000000000000000000000000000000000000000000000000000000M00M00000000000<9999999999980000000000<99>000000000000000000000
000000000000000000000000000000000000000000000000000000000000000000000000000000000411111111126800000<99999999999>00000000000000000000000000000000000
0000000000000000000000000000000000000000000000000000000000000000000M0000000000007999999999999>000000<9999999999>00000000000000000000000000000000000
0004111111111112800M000000000000000000000000000000000000000000076666666668000000<999999999999>00000000<9999999>000000000000000000000000000000000000
000<9999999999999666666680000M00000000000000000000000000000000799999999999500000<99999999999>00000000000000<>00000000000000000000000000000000000000
000<99999999999999999999966311112666680000M0000000000000000007999999999999950000<9999999999>0000000000000000000000000000000000000000000000000000000
000<99999999999999999999999999999999996631111111500M00M00M00799999999999999>00000<9999999>000000000000000000000000000000000000000000000000000000000
000<99999999999999999999999999999999999999999999961111111166999999999999999>000000<999>000000000000000000000000000000000000000000000000000000000000
000<99999999999999999999999999999999999999999999999999999999999999999999999>00000000000000000000000000000000000000000000000000000000000000000000000
0000<9999999999999999999999999999999999999999999999999999999999999999999999>00000000000000000000000000000000000000000000000000000000000000000000000
00000<9999999999999999999999999999999999999999999999999999999999999999999>0000000000000000000000000000000000000000000000000000000000000000000000000
0000000<99999999999999999999999999999999999999999999999999999999999999>0000000000000000000000000000000000000000000000000000000000000000000000000000
0000000000000000000000000<9999999999999999999999999999999999999>00000000000000000000000000000000000000000000000000000000000000000000000000000000000
0000000000000000000000000000000000000000<99999999999999999>0000000000000000000000000000000000000000000000000000000000000000000000000000000000000000
000000000000000000000000000000000000000000000000000<99999>00000000000000000000000000000000000000000000000000000000000000000000000000000000000000000
000000000000000000000000000000000000000000000000000000000000000000000000000000000000000000000000000000000000000000000000000000000000000000000000000
000000000000000000000000000000000000000000000000000000000000000000000000000000000000000000000000000000000000000000000000000000000000000000000000000
000000000000000000000000000000000000000000000000000000000000000000000000000000000000000000000000000000000000000000000000000000000000000000000000000
000000000000000000000000000000000000000000000000000000000000000000000000000000000000000000000000000000000000000000000000000000000000000000000000000
000000000000000000000000000000000000000000000000000000000000000000000000000000000000000000000000000000000000000000000000000000000000000000000000000
000000000000000000000000000000000000000000000000000000000000000000000000000000000000000000000000000000000000000000000000000000000000000000000000000