000000000000000000000000000000000000000000000000000000000000000000000000000000000000000000000000000000000000000000000000000000000000000000000000000
000000000000000000000000000000000000000000000000000000000000000000000000000000000000000000000000000000000000000000000000000000000000000000000000000
000000000000000000000000000000000000000000000000000000000000000000000000000000000000000000000000000000000000000000000000000000000000000000000000000
000000000000000000000000000000000000000000000000000000000000000000000000000000000000000000000000000000000000000000000000000000000000000000000000000
000000000000000000000000000000000000000000000000000000000000000000000000000000000000000000000000000000000000000000000000000000000000000000000000000
111111111111111111111111111111111111111111111111111111111111111111111111111111111111111111111111111111111111111111111111111111111111111111111111111
111111111111111111111111111111111111111111111111111111111111111111111111111111111111111111111111111111111111111111111111111111111111111111111111111
111111111111111111111111111111111111111111111111111111111111111111111111111111111111111111111111111111111111111111111111111111111111111111111111111
111111111111111111111111111111111111111111111111111111111111111111111111111111111111111111111111111111111111111111111111111111111111111111111111111
111111111111111111111111111111111111111111111111111111111111111111111111111111111111111111111111111111111111111111111111111111111111111111111111111
111111111111111111111111111666666666666111111111111111111111111111111111111111111111111111111111111111111111111111111111111111111111111111111111111
111111111111111111116666665000000000000766666666111111111111111111111111111111111111111111111111111111111111111111111111111111111111111111111111111
111111111111111116650000000000000000000000000000811111111111111111111111111111111111111111111111111111111111111111111111666611111111111111111111111
111111111111111140000000000000000000000000000000766611111111111111111111111111111111111111111111116666666666661111111115000071111111111111111111111
111111111111116650000000000000000000000000000000000076111111111111111111111111111111111111111111650000000000007666611140000008111111111111111111111
111111111166650000000000000000000000000000000000000000766666111111111111116666666666666661111114000000000000000000081140000008111111111111111111111
111111111400000000000000000000000000000000000000000000000000811111111111150000000000000007661111230000000000000092211113000091111111111111111111111
111111111500000000000000000000000000000000000000000000000009111111111166500000000000000000008111113000000000092211111111222211111111111111111111111
111111115000000000000000000000000000000000000000000000000007611111111400000000000000000000008111111300000009211111111111111111111111111111111111111
111111140000000000000000000000000000000000000000000000000000081111111500000000000000000000921111111130000091111111111111111111111111111111111111111
111111112230000000000000000000000000000000000000000000000000071111114000000000000000000000811111111112222211111111111111111111111111111111111111111
111111111112300000000000000000000000000000000000000000000000007111115000000000000000009222111111111111111111111111111111111111111111111111111111111
111111111111122222222300000000000000000000000000000000000000000766140000000000000000091111111111111111111111111111111111111111111111111111111111111
111111111111111111111123000000000000000000000000000000000000000000812300000000092222211111111111111111111111111111111111111111111111111111111111111
111111111111111111111111222222222230000000000000000000000000000092111122222222211111111111111111111111111111111111111111111111111111111111111111111
111111111111111111111111111111111112222230000000000000000000922211111111111111111111111111111111111111111111111111111111111111111111111111111111111
111111111111111111111111111111111111111112222222222222222222111111111111111111111111111111111111111111111111111111111111111111111111111111111111111
111111111111111111111111111111111111111111111111111111111111111111111111111111111111111111111111111111111111111111111111111111111111111111111111111
111111111111111111111111111111111111111111111111111111111111111111111111111111111111111111111111111111111111111111111111111111111111111111111111111
111111111111111111111111111111111111111111111111111111111111111111111111111111111111111111111111111111111111111111111111111111111111111111111111111
111111111111111111111111111111111111111111111111111111111111111111111111111111111111111111111111111111111111111111111111111111111111111111111111111
111111111111111111111111111111111111111111111111111111111111111111111111111111111111111111111111111111111111111111111111111111111111111111111111111
111111111111111111111111111111111111111111111111111111111111111111111111111111111111111111111111111111111111111111111111111111111111111111111111111
111111111111111111111111111111111111111111111111111111111111111111111111111111111111111111111111111111111111111111111111111111111111111111111111111
111111111111111111111111111111111111111111111111111111111111111111111111111111111111111111111111111111111111111111111111111111111111111111111111111
111111111111111111111111111111111111111111111111111111111111111111111111111111111111111111111111111111111111111111111111111111111111111111111111111
000000000000000000000000000000000000000000000000000000000000000000000000000000000000000000000000000000000000000000000000000000000000000000000000000
000000000000000000000000000000000000000000000000000000000000000000000000000000000000000000000000000000000000000000000000000000000000000000000000000
000000000000000000000000000000000000000000000000000000000000000000000000000000000000000000000000000000000000000000000000000000000000000000000000000
000000000000000000000000000000000000000000000000000000000000000000000000000000000000000000000000000000000000000000000000000000000000000000000000000