000000000000000000000000000000000000000000000000000000000000000000000000000000000000000000000000000000000000000000000000000000000000000000000000000
000000000000000000000000000000000000000000000000000000000000000000000000000000000000000000000000000000000000000000000000000000000000000000000000000
000000000000000000000000000000000000000000000000000000000000000000000000000000000000000000000000000000000000000000000000000000000000000000000000000
000000000000000000000000000000000000000000000000000000000000000000000000000000000000000000000000000000000000000000000000000000000000000000000000000
000000000000000000000000000000000000000000000000000000000000000000000000000000000000000000000000000000000000000000000000000000000000000000000000000
000000000000000000000000000000000000000000000000000000000000000000000000000000000000000000000000000000000000000000000000000000000000000000000000000
000000000000000000000000000000000000000000000000000000000000000000000000000000000000000000000000000000000000000000000000000000000000000000000000000
000000000000000000000000000000000000000000000000000000000000000000000000000000000000000000000000000000000000000000000000000000000000000000000000000
000000000000000000000000000000000000000000000000000000000000000000000000000000000000000000000000000000000000000000000000000000000000000000000000000
000000000000000000000000000000000000000000000000000000000000000000000000000000000000000000000000000000000000000000000000000000000000000000000000000
111111111111111111111111111111111111400000000000008111111111111114000000081111114008111111111111111111114000000000000000000000000000000000000000000
11111^1111111111111^111111111<111111400000000000008111111111111114000000081111114008111111111111111111114000000000000000000000000000000000000000000
111111111111111111111111111111111111400000000000008111111111<11114000000081111114008111111111111111111114000000000000000000000000000000000000000000
111111111111111111111111<1111111^111400000000000008111111111111114000000081111114008111111111111111111114000000000000000000000000000000000000000000
111111111111^1111111111111111111111140000000000000811111^111111114000000081111114008111111111111111111115000000000000000000000000000000000000000000
11111111111111111111111111<11111<116500000000000008111111111111114000000081111114008111111111111111111140000000000000000000000000000000000000000000
11111111<1111111111111111111111116500000000000000081111111<1111114000000081111114008111111111111111111150000000000000000000000000000000000000000000
111111111111111io11111111^1111115000000000000000007661^11111111114000000076666665008111111111111111116500000000000000000000000000000000000000000000
111111111111111kl1111111116666650000000000000000000008111111666665000000000000000007111111111111111140000000000000000000000000000000000000000000000
1111111<1111111111111116650000000000000000000000000007666665000000000000000000000000766666666666666650000000000000000000000000000000000000000000000
111111111111111111111150000000000000000000000000000000000000000000000000000000000000000000000000000000000000000000000000000000000000000000000000000
111111111111111111111400000000000000000000000000000000000000000000000000000000000000000000000000000000000000000000000000000000000000000000000000000
111111111111111111111111111111111111100000000000000000000000000000000000000000000009222222222222222300000000000000000000000000000000000000000000000
111111111111111111111111111111111111100000000000001111111111111230009222222230000091111111111111111123000000000000000000000000000000000000000000000
111111111111111111111111111111111111111111111111111111111111111140008111111140000081111111111111111114000000000000000000000000000000000000000000000
111111111111111111111111111111111111111111111111111111111111111150008111111140000081111111111111111114000000000000000000000000000000000000000000000
1111111111111111111111111111111111111111111111111111111111^1116500008111111150000081111111111111111114000000000000000000000000000000000000000000000
111111111111111111111111111111111111111111111111111111111111150000008111111400000081111111111111111114000000000000000000000000000000000000000000000
111111111111111111111111111111111111111111111111111111<11166500000008111111500000076666666666666666665000000000000000000000000000000000000000000000
111111111111111111111111111111111111111111111111111111116500000000008111115000000000000000000000000000000000000000000000000000000000000000000000000
111111111111111111111111111111111111111111111111111111150000000000008111140000000000000000000000000000000000000000000000000000000000000000000000000
111111111111111111111111111111111111111111111111111111500000000000008111140000000000000000000000000000000000000000000000000000000000000000000000000
666666666666666666666666666666666666666666666666666400000000000000007666650000000000000000000000000000000000000000000000000000000000000000000000000
000000000000000000000000000000000000000000000000000000000000000000000000000000000000000000000000000000000000000000000000000000000000000000000000000
000000000000000000000000000000000000000000000000000000000000000000000000000000000000000000000000000000000000000000000000000000000000000000000000000
000000000000000000000000000000000000000000000000000000000000000000000000000000000000000000000000000000000000000000000000000000000000000000000000000
000000000000000000000000000000000000000000000000000000000000000000000000000000000000000000000000000000000000000000000000000000000000000000000000000
000000000000000000000000000000000000000000000000000000000000000000000000000000000000000000000000000000000000000000000000000000000000000000000000000
000000000000000000000000000000000000000000000000000000000000000000000000000000000000000000000000000000000000000000000000000000000000000000000000000
000000000000000000000000000000000000000000000000000000000000000000000000000000000000000000000000000000000000000000000000000000000000000000000000000