000000000000000000000000000000000000000000000000000000000000000000000000000000000000000000000000000000000000000000000000000000000000000000000000000
000000000000000000000000000000000000000000000000000000000000000000000000000000000000000000000000000000000000000000000000000000000000000000000000000
000000000000000000000000000000000000000000000000000000000000000000000000000000000000000000000000000000000000000000000000000000000000000000000000000
000000000000000000000000000000000000000000000000000000000000000000000000000000000000000000000000000000000000000000000000000000000000000000000000000
000000000000000000000000000000000000000000000000000000000000000000000000000000000000000000000000000000000000000000000000000000000000000000000000000
000000000000000000000000000000000000000000000000000000000000000000000000000000000000000000000000000000000000000000000000000000000000000000000000000
000000000000000000000000000000000000000000000000000000000000000000000000000000000000000000000000000000000000000000000000000000000000000000000000000
000000000000000000000000000000000000000000000000000000000000000000000000000000000000000000000000000000000000000000000000000000000000000000000000000
000000000000000000000000000000000000000000000000000000000000000000000000000000000000000000000000000000000000000000000000000000000000000000000000000
000000000000000000000000000000000000000000000000000000000000000000000000000000000000000000000000000000000000000000000000000000000000000000000000000
000000000000000000000000000000000000000000000000000000000000000000000000000000000000000000000000000000000000000000000000000000000000000000000000000
000000000000000000000000000000000000000000000000000000000000000000000000000000000000000000000000000000000000000000000000000000000000000000000000000
000000000000000000000000000000000000000000000000000000000000000000000000000000000000000000000000000000000000000000000000000000000000000000000000000
000000000000000000000000000000000000000000000000000000000000000000000000000000000000000000000000000000000000000000000000000000000000000000000000000
000000000000000000000000000000000000000000000000000000000000000000000000000000000000000000000000000000000000000000000000000000000000000000000000000
000000000000000000000000000000000000000000000000000000000000000000000000000000000000000000000000000000000000000000000000000000000000000000000000000
000000000000000000000000000000000000000000000000000000000000000000000000000000000000000000000000000000000000000000000000000000000000000000000000000
000000000000000000000000000000000000000000000000000000000000000000000000000000000000000000000000000000000000000000000000000000000000000000000000000
000000000000000000000000000000000000000000000000000000000000000000000000000000000000000000000000000000000000000000000000000000000000000000000000000
000000000000000000000000000000000000000000000000000000000000000000000000000000000000000000000000000000000000000000000000000000000000000000000000000
000000000000000000000000000000000000000000000000000000000000000000000000000000000000000000000000000000000000000000000000000000000000000000000000000
0000000000000000000000000000000000000000000000000000000000000000000000M0000000000000000000000000000000000000000000000000000000000000000000000000000
00000000041111111111111111112666666680000000000000000000M000000000004112680000000000000000000000000000000000000000000000000000000000000000000000000
000000000<99999999999999999^99999999>0M0M00000M0M0766631112666800000<9999>00000000000M00M00M00M00M00M0000000000000000000000000000000000000000000000
0000000000<99999^999999999766666899996666666666666999999999999>00000<999^>00000000766311111111266311111115000000000000M0O0M000000000000000000000000
0000000000<9^99999999999^9<99999>99999999999999999999^9999999>000000<9^99>00000000<9999999999999999^99999>00000000766311111500000000000000000000000
000000000000<99999^9999999<99999>999999999999^9999999999999>00000000<9999>000000000<9999999^999999999999>000000000<99999999>00000000000000000000000
000000000000<9999999999999<9^999>9999^9999999999999999999>0000000000<99^9>0000000000<999999999999999>00000000000000<999999>000000000000000000000000
0000000000000<999^99999999<9^999>99999999999999999999999^>0000000000<9^99>00000000000<99999999999>000000000000000000<9999>0000000000000000000000000
000000000000000000<9999999999999999999999999999999>00000000000000000<9999>00000000000<9999999999>0000000000000000000<9>0000000000000000000000000000
0000000000000000000000<999>0000000<99999999999>000000000000000000000<99>000000000000000<9>000<9>00000000000000000000<9>0000000000000000000000000000
00000000000000000000000<99>00000000<9999999999>0000000000000000000000000000000000000000000000<9>000000000000000000000000000000000000000000000000000
000000000000000000000000000000000000000<999999>0000000000000000000000000000000000000000000000000000000000000000000000000000000000000000000000000000
000000000000000000000000000000000000000000000000000000000000000000000000000000000000000000000000000000000000000000000000000000000000000000000000000
000000000000000000000000000000000000000000000000000000000000000000000000000000000000000000000000000000000000000000000000000000000000000000000000000
000000000000000000000000000000000000000000000000000000000000000000000000000000000000000000000000000000000000000000000000000000000000000000000000000
000000000000000000000000000000000000000000000000000000000000000000000000000000000000000000000000000000000000000000000000000000000000000000000000000
000000000000000000000000000000000000000000000000000000000000000000000000000000000000000000000000000000000000000000000000000000000000000000000000000
000000000000000000000000000000000000000000000000000000000000000000000000000000000000000000000000000000000000000000000000000000000000000000000000000
000000000000000000000000000000000000000000000000000000000000000000000000000000000000000000000000000000000000000000000000000000000000000000000000000